[5,11]
(0,3)
(6,2)
(1,1,1,2)
(2,2,1,2)
(2,3,8,1)
(9,1,1,3)
(5,1,5,1)